############################
# @ #  ##     %  #C       ##                 
#   #   C # #    #####  #  #         
#   # ####### ### #  #  #C #
#  C# #     #  C  #  %  #  #
#  C#&#  # C#######     ##C#
#   ###         C#  #C   ###
#     #   C   #  #  #    #%# 
#C  # #   C   #     #    # #
##### #   C   #######    # #
#%  #     %   #     ###### #
## ############       CC   #
#  #  #    # #             #
# X     #  #   C    C     C#
############################