###########################
# @   #%        C    #   C#
#     #    C         # &  #
#  ########### ########## #
#  %#    #      C   C#    #
#   # CCC    #       #C   #
##################   #    #
# %                     C #
###########################
#         C           X   #
# #######   ####   ####   #
# #C    #   C  #C  # C#   #
# #  C# #####  #   # C#   #
# ## ####      #   # C#   #
#              ##  #  #   #
#%         C             C#
###########################